%%%%%%%%%%%%%%%%%%%%
%.   %     .  %    %
% %% % %%%%%% % %% %
% %              % %
% % %% %%  %% %% % %
%.     %    %      %
% % %% %%%%%% %% % %
% %.             % %
% %% % %%%%%% % %% %
%    %   P    %    %
%%%%%%%%%%%%%%%%%%%%
